##################
#______t_________#
#S>>>>>>>>>>>v___#
#______t_____v___#
#___v<<<<<<<<<___#
#_v<<______t_____#
#_v______________#
#_>>>>>>>>>>>>>>X#
#______t_________#
##################