##########
#________#
#___v<<<_#
#___v__^_#
#_X<<__^_#
#______^_#
#___S>>^_#
#________#
#________#
##########