#########################
#____t__________________#
#_______>>>>>>>>X_______#
#___>>>>^_______________#
#___^______t____________#
#___^<<<<<<<<<<<________#
#__S___________^________#
#__>>>>>>>>>>>>^___t____#
#_______________________#
#########################